.....x....x..x........
..ppppppppppppppp.....
..p.....x.....x.p.x...
.xp.x..x...x....p.....
sppxpppppppppp..px....
...xpx..x..x.pppp.....
...xp.....ppp.x.......
....p.x..xp.p.........
...xp.....p.p.x.......
...xpx..x.p.p...x.....
....ppppppp.ppppppp...
......x......x....px..
.................xp...
..................px..
..................p...
..................f...
Enemies 20
Enemy_Speed 8
Enemy_Max_Health 300
EnemiesSpawnTime 1500000000