......................
...pppppppx...........
...p.....pxx..........
...p..x..p.x....x.....
sppp.....ppppppp..pppf
......x....x...px.p...
..x.pppppppppppp..px..
....p..x..x..x..x.px..
..x.p.x...........px..
....p....x..x..x..p...
..x.pppppppppppppppx..
....x..x...x.x...x....
......................
......................
......................
......................
Enemies 50
Enemy_Speed 12
Enemy_Max_Health 800
EnemiesSpawnTime 1000000000