s.....................
p.x...................
p.....................
p...x.................
ppppppppppppp.........
.....x.....xp.........
............p.........
.........x..p.........
............p.x.......
............p...x.....
............pppppppppf
.............x....x...
......................
......................
......................
......................